@@@@@@@@@@@@@@@@@@|
@@@@@@@@@@@@@@@@@@|
@@@RRRD---DRRRR@@@|
@@@-CR--G--RB-B@@@|
@@@@@@@@@@@@@@@@@@|
@@@@@@@@@@@@@@@@@@|
@@@RRRRR-------@@@|
@@@-P-BRD---D-L@@@|
@@@@@@@@@@@@@@@@@@|
@@@@@@@@@@@@@@@@@@|
!L0 D0|B2 D1|B0 D2|B1 D3|