@@@@@@@@@@@@@@@@@@@@@@@@@|
@@@@@@@@@@@@@@@@@@@@@@@@@|
@@@--DRRR@@RRRD---DRRRR@@|
@@@A--RGR@@-CR--A--R-C-@@|
@@@A@@@@@@@@@@@@A@@@@@@@@|
@@@A@@@@@@@@@@@@A@@@@@@@@|
@@-A--RRRRRRRR--A------@@|
@@TA--R------R--A-D-B-A@@|
@@@A@@@@@@@@@@@@A@@@@@A@@|
@@@A@@@@@@@@@@@@A@@@@@A@@|
@@@A---@@RRRRRR-A@@---A@@|
@@@A-P-@@-B---R-A@@C--A@@|
@@@@@@@@@@@@@@@@@@@@@@@@@|
@@@@@@@@@@@@@@@@@@@@@@@@@|
!B0 D0|B0 D1|B1 D2|B0 D3|



