----------|
------@---|
---@@@@---|
---@@@@---|
---@@@@---|
----@-----|
----------|